alias '['='~/.cargo/bin/coreutils ['
alias b2sum='~/.cargo/bin/coreutils b2sum'
alias b3sum='~/.cargo/bin/coreutils b3sum'
alias base32='~/.cargo/bin/coreutils base32'
alias base64='~/.cargo/bin/coreutils base64'
alias basename='~/.cargo/bin/coreutils basename'
alias basenc='~/.cargo/bin/coreutils basenc'
# There's 'bat' for that
# alias cat='~/.cargo/bin/coreutils cat'
alias cksum='~/.cargo/bin/coreutils cksum'
alias comm='~/.cargo/bin/coreutils comm'
alias cp='~/.cargo/bin/coreutils cp'
alias csplit='~/.cargo/bin/coreutils csplit'
alias cut='~/.cargo/bin/coreutils cut'
alias date='~/.cargo/bin/coreutils date'
alias dd='~/.cargo/bin/coreutils dd'
alias df='~/.cargo/bin/coreutils df'
alias dir='~/.cargo/bin/coreutils dir'
alias dircolors='~/.cargo/bin/coreutils dircolors'
alias dirname='~/.cargo/bin/coreutils dirname'
alias du='~/.cargo/bin/coreutils du'
alias echo='~/.cargo/bin/coreutils echo'
alias env='~/.cargo/bin/coreutils env'
alias expand='~/.cargo/bin/coreutils expand'
alias expr='~/.cargo/bin/coreutils expr'
alias factor='~/.cargo/bin/coreutils factor'
alias false='~/.cargo/bin/coreutils false'
alias fmt='~/.cargo/bin/coreutils fmt'
alias fold='~/.cargo/bin/coreutils fold'
alias hashsum='~/.cargo/bin/coreutils hashsum'
alias head='~/.cargo/bin/coreutils head'
alias join='~/.cargo/bin/coreutils join'
alias link='~/.cargo/bin/coreutils link'
alias ln='~/.cargo/bin/coreutils ln'
alias ls='~/.cargo/bin/coreutils ls'
alias md5sum='~/.cargo/bin/coreutils md5sum'
alias mkdir='~/.cargo/bin/coreutils mkdir'
alias mktemp='~/.cargo/bin/coreutils mktemp'
alias more='~/.cargo/bin/coreutils more'
alias mv='~/.cargo/bin/coreutils mv'
alias nl='~/.cargo/bin/coreutils nl'
alias numfmt='~/.cargo/bin/coreutils numfmt'
alias od='~/.cargo/bin/coreutils od'
alias paste='~/.cargo/bin/coreutils paste'
alias pr='~/.cargo/bin/coreutils pr'
alias printenv='~/.cargo/bin/coreutils printenv'
alias printf='~/.cargo/bin/coreutils printf'
alias ptx='~/.cargo/bin/coreutils ptx'
alias pwd='~/.cargo/bin/coreutils pwd'
alias readlink='~/.cargo/bin/coreutils readlink'
alias realpath='~/.cargo/bin/coreutils realpath'
alias rm='~/.cargo/bin/coreutils rm'
alias rmdir='~/.cargo/bin/coreutils rmdir'
alias seq='~/.cargo/bin/coreutils seq'
alias sha1sum='~/.cargo/bin/coreutils sha1sum'
alias sha224sum='~/.cargo/bin/coreutils sha224sum'
alias sha256sum='~/.cargo/bin/coreutils sha256sum'
alias sha3-224sum='~/.cargo/bin/coreutilssha3-224sum'
alias sha3-256sum='~/.cargo/bin/coreutilssha3-256sum'
alias sha3-384sum='~/.cargo/bin/coreutilssha3-384sum'
alias sha3-512sum='~/.cargo/bin/coreutilssha3-512sum'
alias sha384sum='~/.cargo/bin/coreutils sha384sum'
alias sha3sum='~/.cargo/bin/coreutils sha3sum'
alias sha512sum='~/.cargo/bin/coreutils sha512sum'
alias shake128sum='~/.cargo/bin/coreutilsshake128sum'
alias shake256sum='~/.cargo/bin/coreutilsshake256sum'
alias shred='~/.cargo/bin/coreutils shred'
alias shuf='~/.cargo/bin/coreutils shuf'
alias sleep='~/.cargo/bin/coreutils sleep'
alias sort='~/.cargo/bin/coreutils sort'
alias split='~/.cargo/bin/coreutils split'
alias sum='~/.cargo/bin/coreutils sum'
alias tac='~/.cargo/bin/coreutils tac'
alias tail='~/.cargo/bin/coreutils tail'
alias tee='~/.cargo/bin/coreutils tee'
alias test='~/.cargo/bin/coreutils test'
alias touch='~/.cargo/bin/coreutils touch'
alias tr='~/.cargo/bin/coreutils tr'
alias true='~/.cargo/bin/coreutils true'
alias truncate='~/.cargo/bin/coreutils truncate'
alias tsort='~/.cargo/bin/coreutils tsort'
alias unexpand='~/.cargo/bin/coreutils unexpand'
alias uniq='~/.cargo/bin/coreutils uniq'
alias unlink='~/.cargo/bin/coreutils unlink'
alias vdir='~/.cargo/bin/coreutils vdir'
alias wc='~/.cargo/bin/coreutils wc'
alias yes='~/.cargo/bin/coreutils yes'
